NO ./textures/no_texture.xpm
NOS ./textures/north_sprite.xpm
SO ./textures/so_texture.xpm
WE ./textures/we_texture.xpm
EA ./textures/ea_texture.xpm
DOOR ./textures/door_texture.xpm

C 100,100,100
F 0,0,0


        111111111111111111111111111
        1000000000110000000000001
        10110000011100001110000011111
        10010000000000001 1000001
111111111011000001110000111000001111111111
100000000011000001110111111111111
11110111111111011100000010001
11110111111111011101010020001
11000000110101011100000010001
10000000000000000200000S20001
10000000000000001101010010001
1100000111010101111101121000111
11110111 1110101 101111010001
11111111 1111111 111111111111
